11111111111111111111
1x000000000000000001
11111110001000000001
11100010000000010001
11101010000000000001
10001011111110111111
10111000000000000001
10001110000000000001
11101111111111111111
10000000000000000001
10100000000000000101
10000000000000000001
10000000000000000001
10000000011000000001
10000000011000000001
10000000000000000001
10000000000000000001
10100000000000000101
10000000000000000001
11111111111111111111